................
................
................
................
....########....
....#?#N####....
....########....
....###S####....
....########....
....#R####B#....
....###Z####....
....########....
................
................
................
................
